*************
*           *        *******
*   *****   *        *  #  *
*       *   *        * * * ********
*   *   *   ********** * *        *
*   *   *      * #*    * *******  *
*   *   *   *     *    *          *
*   *   *   *******    ****  **** *
*   *                           * *
*   ***************    ********** *
*#      *   *   *      *#         *
********* * * * * *****************
        * * * * * *
        * * x *   *
        ***********
