*************************
*     *   *             *
* *** * * * ******* *** *
*   * * *   *     *** * *
* * * ***** * * *       *
* * *   * * * * ***** ***
* * * *   * * *         *
* * * ***** * **** **** *
* *                   * *
* *********** ********* *
*   * *   *   *         *
***** * * * *** *********
*       *   *           *
*************************
