*************************
*  #  *   *            #*
* *** * * * ******* *** *
*   * *#*   *     *** * *
* * * ***** * * *       *
* * *   *#* * * ***** ***
* * * *   * * *         *
* * * ***** * **** **** *
* *                  #*#*
* *********** ********* *
*  #* *   *   *         *
***** * * * *** *********
*#      *   *          #*
*************************
